###     ########     ####
                        #
#                       #
                         
                         
#                       #     
                        #
                         
#                       #
#                       #
#                        
#                       #
#                       #
                         
###      #######    #####